DIY Platform Bench With Built In Side Table | Modern Builds | EP. 65
DIY Modern Mini-Kitchen / Kitchenette Build || Home Improvement
DIY Mid-Century Modern Plywood Bookcase / Shelf. FREE PLANS
Mid Century Modern Console Table DIY | Modern Builds | EP. 11
DIY Wood and Metal Dining Table with NO WELDING!! | Modern Builds
DIY Mid-Century Modern Credenza / Console Table | Modern Builds | EP. 48
DIY Platform Bed Made from ONLY 2x4's!!  | Modern Builds
DIY Sleeper Sofa / Futon that Turns Into a Bed! | Modern Builds
DIY Mid-Century Modern Slatted Coffee Table | Modern Builds | EP. 49
HOW TO POUR DIY EPOXY MARBLE COUNTERTOPS | Modern Builds
DIY Modern Outdoor Chair | How to Build
How To: DIY Modern Kitchen Cabinet Remodel | Update Cabinets on a Budget | Modern Builds | EP. 46
DIY Modern Dining Table w/ Matching Benches | Modern Builds
DIY Mid Century Modern Desk | How To | Modern Builds | EP. 60
DIY SOFA MADE OUT OF 2X4'S + FREE PLANS | MODERN BUILDS
DIY SOLAR POWERED WORKSHOP | MODERN BUILDS x GOAL ZERO
How To Build Modern Window Shutters | Modern Builds
DIY MODERN WOOD SLAT KITCHEN ISLAND / PENINSULA
DIY Mid-Century Modern Media Console | #Woodworking
Crazy Easy Modern Dining Table || insanely easy table build
DIY Bowling Alley Coffee Table | Modern Builds | EP. 35
DIY SCHOOL BUS TINY HOUSE CONVERSION EP. 1 | MODERN BUILDS
DIY Modern Outdoor Sofa | How to Build
DIY VINYL RECORD MEDIA CABINET W/ STORAGE | MODERN BUILDS
DIY MODERN DRESSER | IKEA HACK | TARVA DRESSER
DIY SECTIONAL SOFA + FREE PLANS | MODERN BUILDS
How to Build a Modern Vanity Desk // Woodworking Project // DIY Modern Furniture
DIY Mid Century Modern Side Table / End Table | Modern Builds | EP. 69
DIY GARAGE STORAGE / WORKBENCH | MODERN BUILDS
How To Build a Dining Table | Modern Builds | EP. 33
DIY Round Farmhouse Dining Table | Modern Builds | EP. 52
BUILDING an EPOXY POUR VANITY!! | MODERN BUILDS DIY
Inside Modern Build's DIY Desert Cabin | Open Door | 2023 JOSHUA TREE HOUSE TOUR
DIY Modern Bookshelf | Modern Builds | EP. 75
DIY MID CENTURY MODERN PLATFORM BED | Modern Builds
EP. 5: THE LIVING ROOM | DIY SCHOOL BUS TINY HOUSE CONVERSION | MODERN BUILDS
How To Build a Modern Picnic Table | Easy Outdoor DIY | Modern Builds EP. 71
The Ux4 Desk | Modern Builds | EP. 28
COMPLETELY DIY BEDROOM RENOVATION | Modern Builds
DIY WEIGHT BENCH from 2x4's | Modern Builds
How To Build a Modern Plywood Media Console // DIY
DIY Mid Century Modern Console Table | Modern Builds | EP. 6
DIY Mid-Century Modern Sofa | Modern Builds | EP. 27
Mid Century Modern Coffee Table DIY | Modern Builds | EP. 10
Modern Live Edge Coffee Table | Modern Builds | EP. 24
DIY Overlay Concrete Countertops | Modern Builds | EP. 18
DIY Wine Box Planter | Modern Builds | EP. 38
EP. 2: THE BEDROOM | DIY SCHOOL BUS TINY HOUSE CONVERSION | MODERN BUILDS
DIY Concrete Pendant Light | Modern Builds | EP. 42
Wooden Pendant Light | Woodturning | Modern Builds
DIY Modern Platform Bed With Storage | Modern Builds | EP. 56 | How-To
DIY Floating Shelf from Plywood and Copper | Modern Builds
DIY Picture Frame with Solid Wood Matting | #Two2x4Challenge | Modern Builds | EP. 63
How To Build A Modern Outdoor Sofa | DIY
Q&A: SCHOOL BUS TINY HOUSE | MODERN BUILDS
How To Build A Bat House | Modern Builds | EP. 40
How to Build DIY LAMINATE COUNTERTOPS with EXPOSED PLYWOOD Edges | Modern Builds
DIY Modern Outdoor Kitchen and Bar | Modern Builds | EP. 21
DIY Modern Platform Bed | Modern Builds EP. 47
DIY Dog House | Modern Dog House with Sustainable Materials
DIY Modern Wall Shelf / Desk | Metal and Plywood | Modern Builds
How To Build a Mid Century Modern Dog Bed | Modern Builds | EP. 72 | DIY
DIY Affordable Kitchen Countertops || Airstream Build Out
EP. 4: THE KITCHEN | DIY SCHOOL BUS TINY HOUSE CONVERSION | MODERN BUILDS
DIY Power-Carved Egg Table | Modern Builds | EP. 55 | ARBORTECH TURBOPLANE
DIY SHED TO WORKSHOP TRANSFORMATION | PAINTING PLYWOOD WALLS & CONCRETE EPOXY | MODERN BUILDS EP. 2
DIY Towel Rack & Bathroom Organizer | Modern Builds | EP. 51
Build A Simple Modern Indoor Fire Wood Rack | Modern Builds | EP. 53
Modern Split-Top Dining Table | DIY | Modern Builds
How to Make a Modern Mirror Frame // Woodworking // DIY Project // Scrap Project
How To Build a Dog House | Modern Builds | EP. 41
DIY  Modern Slatted Bench | Modern Builds | EP. 39
DIY A-Frame Ladder Bookshelf | Modern Builds | EP. 62
SHED TO WORKSHOP Ep. 3 | Installing Corrugated Sheet Metal Roof | Modern Builds
DIY Modern Sliding Barn Door | Modern Builds | EP. 43
3 Tier Metal & Wood Book Shelf | Modern Builds | DIY
DIY Concrete Gel Fire Pit *EASY*  | Modern Builds | EP. 5
How I Built a Clothing Store in a WEEK // For Under $2,500 // Modern Builds
DIY Modern Outdoor Lounge Chair | Modern Builds | EP. 44
DIY Mid-Century Modern Sliding Barn Door | Modern Builds | EP 54
DIY Floating Log End Table | Modern Builds | EP. 4
Building a Simple and Stylish Modern Bed...Mattress not included
DIY Live Edge Cake Stand | Modern Builds
DIY Wooden Hair Comb | With Template | Modern Builds EP. 50
DIY Live Edge Slab Coffee Table | Modern Builds | EP. 23
DIY MID CENTURY MODERN END TABLE | Modern Builds | EP. 29
DIY Modern Concrete Coffee Table | Modern Builds | EP. 32
How To Make White Concrete | A Modern Builds Experiment
DIY Steel-Based Candles | Modern Builds
How to Make an Outdoor Steel Fire Pit | Modern Builds | EP. 73
DIY Concrete Wall Clock | Modern Builds | EP. 45
HOW TO PAINT A SCHOOL BUS!!! DIY SCHOOL BUS TINY HOUSE CONVERSION Ep. 6 | MODERN BUILDS
How to Build a Penny Board | Modern Builds | EP. 8 | With Template
Building a Reclaimed Wood Top Dining Table | Modern Builds | EP. 70
DIY Portable Concrete Fire Pit | Modern Builds
DIY "EARTH-FORMED" CONCRETE & RECLAIMED BEAM VANITY | Modern Builds
DIY Concrete Tabletop Tiki Torch | Modern Builds | EP. 3
DIY Industrial Pipe Hall Stand | Modern Builds | EP. 37
DIY SKIM COAT CONCRETE COUNTERTOPS OVER LAMINATE | Modern Builds
DIY Modern Concrete Bowl Planter | Modern Builds | EP. 1
Build Your First Cutting Board | Modern Builds | EP. 34
EP. 4 SHED TO WORKSHOP TRANSFORMATION | MODERN BUILDS
DIY Desk Lamp With Contoured Base | "Plywood Globe Lamp" | Modern Builds
How to Build a Simple, Sturdy Greenhouse from 2x4's | Modern Builds | EP. 58
DIY Milk Carton Concrete Planter | Modern Builds | EP. 7
DIY Modern Outdoor Bench | Modern Builds | EP. 30
How To Build a Modern Bed w/ Limited Tools | Modern Builds | DIY
DIY Shed to Workshop Conversion | Ep. 1 Modern Builds
Build a Modern Dog House | Modern Builds | EP. 14
How To Make a Headboard | Modern Builds | EP.  26
DIY CONCRETE COUNTERTOPS | OUTDOOR KITCHEN UPDATE | MODERN BUILDS
DIY Foldable Clothes Drying Rack | Modern Builds | EP. 36
$7 DIY ABSTRACT / IRREGULAR / ASYMMETRICAL "BLOB" MIRRORS | MODERN BUILDS
DIY Full Length Mirror | Modern Builds | EP. 59 | How To
DIY Chevron Door Update // Modern Builds
DIY Wood-Burned American Flag | Modern Builds | EP. 17
DIY Wooden Name Sign | Perfect Wedding Gift | Modern Builds | EP. 66
DIY Mid-Century Modern Bed | Modern Builds | EP. 22
How To Make Wooden Christmas Ornaments | Modern Builds | EP. 16
MAKE YOUR STATE From Reclaimed Wood | Modern Builds | EP. 12
Thrift Store Recycle: Mid Century Modern Lamp | Modern Builds | EP. 2
How To Build a Longboard | With Template | Modern Builds | EP. 20
DIY LED "Framed" Mirror | Modern Builds | EP.  74
How To Build a Picture Frame - The Best Way | Modern Builds | DIY
DIY Wooden Stool With Woven Paracord Seat | Modern Builds | EP. 68
From Firewood to Cutting Board | Modern Builds | EP. 19
DIY MEGA CAT TREE | MODERN BUILDS
DIY Mobile Dust Collection | Modern Builds | EP. 25
The $6 DIY Bar Stool Made Out of 2x2's | Modern Builds | EP. 9
DIY Open Concept Living Room Renovation | Modern Builds
DIY ALL-PLYWOOD FLOATING MEDIA CONSOLE | MODERN BUILDS
